#####################
#   #     #   #   # #
# # ### # # # # # # #
# #     #   #   #   #
# ### ############# #
#   # #       #     #
# # ### ##### # #####
# #   # #   # #     #
# ### # # ######### #
#   #   #           #
#####################
